099
o-o-o-o-e
-xxxxxxxx
o-oxo-ox-
xx-x-x-x-
o-o-o-ox-
-xxx-xxx-
-xo-o-o-o
xx-x-x-xx
s-oxo-o--
