199
o-o-o-o-o
-x-D-E-D-
o-o-o-o-o
-D-x-x-D-
o-o-o-o-o
-D-E-D-x-
o-o-o-o-o
-E-E-E-D-
s-o-o-e-o