199
o-o-o-o-o
-D-D-E-D-
o-o-o-o-o
-x-D-D-D-
o-o-o-o-e
-D-E-D-D-
o-o-o-o-o
-E-E-E-D-
s-o-o-o-o